11111111111111111111
10000000000000000EP1
11111111111111111111