11111111111111111111
1000000000000000CE01
11111111111111111111