11111111111111111111
1000000000000A00CEP1
11111111111111111111