11111111111111111101
1000000000000000CEP1
11111111111111111111