11111111111111111111
10000000000000000PC1
11111111111111111111