111111111111111111111111111
111111111111111111111110001
1P00000000C0000000000010001
100111111111111111110010001
100000000000000000000C00001
100111111111111111110000001
10C000000000000000000C11011
100111111111111111110010E01
100000000000000000000010001
111111111111111111111111111